....................
.....###########....
...............#....
...............#....
....................
....................
....................
....................
....................
.........###........
....................
....................
....................
....................
....................
....................
........####........
....................
....................
....................