....................
.....###########....
...............#....
...............#....
....................
....................
..#.................
..#.................
..#.................
....................
....................
....................
....................
....................
....................
.....##########.....
....................
....................
....................
....................