....................
.....###########....
...............#....
...............#....
...####............
......#.............
....................
....................
....................
.............###....
...............#....
...............#....
....................
......#.............
......#.............
....#####...........
....................
....................
....................
....................